﻿FICHA DOS PERSONAGENS 

Ator: Carolzinha/ famosa carol2

Características Básicas
Nome: Débora Szamk (Debbie)
- Sexualidade: Essa pergunta é complicada
- Idade: 19 anos
- Altura: 1,52
- Peso: 60kg
- Cabelo: Castanho com mexas roxas 
- Olhos: Castanhos
- Características físicas: Baixa estatura, unhas curtas, cabelo curto/médio
- Características da personalidade: Observadora, teimosa, protetora, gentil, organizada, criativa
- Curso:  Multimídia

Características Externas
- Onde vive: São Paulo
- Descreva sua família e a relação do personagem com ela: Pais separados recentemente, irmã mais velha (Clara) mora com os avós, a personagem não tem uma boa comunicação com a família
- Melhores amigos: Léo e Nádya
- Hobbies preferidos: Ler, desenhar e escrever 
- Histórico de vida: Presenciou muitas brigas, já teve um pato de estimação, relembra sempre das manhãs que assistia desenhos com sua irmã e das tardes de cantoria


Características Internas

- Características Emocionais e Psicológicas: Calma, analista, questionadora e sensível
- Nível Intelectual: Alto (130 QI)
- O que o motiva: Manter a harmonia ao seu redor
- De que ele tem medo: De se sentir sozinha, de altura e do futuro 
- As três coisas que ele mais estima: Uma vida tranquila, estável onde possa observar as estrelas tranquilamente do seu quintal com um telescópio 
-Sua visão sobre seu papel no mundo: Um ser para questionar a existência de tudo 
-Como é o seu local de repouso: Arrumado e perfumado com luzes espalhadas 
- Outras características importantes: Uma pessoa ansiosa, mas confiante 

Resumo:
- Descrição resumida do personagem: Sou estudante, automaticamente bem curiosa, adoro observar as pessoas e ajudar quem precisa, devido a uma infancia cheia de brigas, eu tento ser o mais calma e paciente possível, adoro animais, dias de sol, sorvete de morango e de se a juntar com galera. 
-Descreva seu personagem com uma frase ou palavra: A curiosidade e a insistencia é uma parte de mim.
